Combustion and Flame	CNF
Journal of Applied Physics	JApPhys
Symposium (International) on Combustion	SIComb
Combustion Science and Technology	CombSciTech
Experiments in Fluids	ExpInFluids
Applied Optics	AppOpt
Proceedings of the Combustion Institute	ProCombInst
Applied Physics B	ApPhysB
Energy & Fuels	EnFuel
Journal of Fluid Mechanics	JFluidMech
Optics Communications	OpComm
Review of Scientific Instruments	RevSciInst
Chinese Chemical Letters	ChiChemLet
Progress in Energy and Combustion Science	PrgEngCombSci
Nanoscale	Nano
Current Opinion in Chemical Engineering	CurOpChemEng
Journal of Materials Chemistry	JMatChem
Journal of Colloid and Interface Science	JColloidIntSci
Chemical & Engineering News Archive	ChemEngNewsA
Journal of Aerosol Science	JAerosolSci
Materials	Mat
Combustion, Explosion, and Shock Waves	CombExpSWave
The Physics of Fluids	PhysFluids
Journal of Computational Physics	JCompPhys
The Journal of Chemical Physics	JChemPhys
Molecular Physics	MolPhys
Physical Review E	PhysRevE
Industrial & Engineering Chemistry Research	IndEngChemRes
Combustion Theory and Modelling	CombTheMod
IMPACT of Computing in Science and Engineering	IMPACTCSE